 4555555555555555555555555555555555555555555555555555556
 3                          7
 3                          7
 3                          7
 3                          7                          7
 3                          7                          7
 3                          71111111                   7
 3                          7                          7
 3                          7                          7
 31111111                   7     1111111              7
 3                          7                          7
 3                   1111   7                   1111   7
 3                                                     7
 3                                                     7
 3                                                     7
 2111111111111111111111111111111111111111111111111111118
